音乐	yīnyuè	music
商场	shāngchǎng	market, bazaar
商	shāng	commerce; trade
常常	chángcháng	frequently; usually; often
常	cháng	often
跟	gēn	to follow, to go with, heel, with, and
有名	yǒumíng	famous, well-known
书	shū	book, letter
报	bào	to announce, to inform, report, newspaper, recompense, revenge
本子	běnzi	book, notebook, edition
那儿	nàr	there
要	yào	demand, ask, request, coerce / important, vital, to want, to be going to, must
师傅	shīfu	master, a qualified worker
香蕉苹果	xiāngjiāo píngguǒ	apple with a banana taste
香蕉	xiāngjiāo	banana
苹果	píngguǒ	apple
对不起	duìbuqǐ	Im sorry, pardon me, forgive me
葡萄	pútao	grape
斤	jīn	catty, about 500g
做	zuò	to do, to make, to produce
家	jiā	-ist, home, family
几	jǐ	almost / how much, how many, several, a few
照片	zhàopiàn	photograph, picture
和	hé	and, together with, with
姐姐	jiějie	older sister
两	liǎng	both, two, ounce, some, a few, tael
弟弟	dìdi	younger brother
一共	yígòng	altogether
小	xiǎo	small, tiny, few, young
狗	gǒu	dog
当然	dāngrán	only natural, as it should be, certainly, of course, without doubt
真	zhēn	real, true, genuine
可爱	kě'ài	amiable, cute, lovely
爱	ài	to love, affection, to be fond of, to like
男	nán	male
工作	gōngzuò	job, work, construction, work, task
大	dà	big, huge, large, major, great, wide, deep, oldest, eldest / doctor
多	duō	many, much, a lot of, numerous, multi-
少	shǎo	few, little, lack / young
喜欢	xǐhuan	to like, to be fond of
外语	wàiyǔ	foreign language
外	wài	outside, in addition, foreign, external
语	yǔ	dialect, language, speech / tell to
百	bǎi	hundred
可以	kěyǐ	can, may, possible, able to
进来	jìnlai	come in
进	jìn	to advance; to enter; to come in
来	lái	to come
朋友	péngyou	friend
记者	jìzhě	reporter, journalist
请问	qǐngwèn	may I ask...
问	wèn	to ask
贵姓	guìxìng	what is your name?
姓	xìng	surname, family name, name
学院	xuéyuàn	college, educational institute, school, faculty
学生	xuésheng	student
什么	shénme	what
学习	xuéxí	to learn, to study
汉语	hànyǔ	Chinese language
英国	yīngguó	England, Britain, English
加拿大	jiānádà	Canada, Canadian
美国	měiguó	America, American, United States, USA
餐厅	cāntīng	dining-hall
哪儿	nǎr	where
这	zhè	this, these / this, these
宿舍	sùshè	dormitory, living quarters
女	nǚ	female, woman
谢谢	xièxie	to thank
我	wǒ	I, me, myself
知道	zhīdao	know, be aware of
没关系	méiguānxi	it doesnt matter
好	hǎo	good, well / be fond of
再见	zàijiàn	good bye
小姐	xiǎojiě	young lady, miss
二	èr	two
〇	líng	zero
四	sì	four
不用	búyòng	need not
这儿	zhèr	here
晚	wǎn	evening, night, late
她	tā	she
是	shì	is, are, am, yes, to be
哪	nǎ	which
国	guó	country, state, nation
人	rén	man, person, people
那	nà	that, those
谁	shéi	who
老师	lǎoshī	teacher
中国	zhōngguó	China, Chinese
你	nǐ	you
医生	yīshēng	doctor
会	huì	can, be possible, be able to, to assemble, to meet, to gather, to see, union, group, association / to balance an account, accounting
司机	sījī	chauffeur, driver
差	chà	difference, error, discrepancy, to differ, to err, to make a mistake, to lack / different, short of, poor, to lack / send, a messenger, a mission, to commission / uneven
上课	shàngkè	to attend class
能	néng	can, may, capable, energy, able
哪里	nǎli	where
教	jiāo	teach / religion, teaching
女儿	nǚér	daughter
数	shù	number; figure; several
拜拜	báibái	bye bye
为什么	wèi shénme	why; for what reason
为	wèi	for
昨天	zuótiān	yesterday
东西	dōngxi	thing, person
玩儿	wánr	to play
晚上	wǎnshang	in the evening
写	xiě	to write
汉字	hànzì	Chinese character
字	zì	letter, symbol, character, word
睡觉	shuìjiào	to go to bed, to go to sleep
睡	shuì	to sleep
起床	qǐchuáng	to get up
起	qǐ	to rise, to raise, to get up
应该	yīnggāi	ought to, should, must
该	gāi	that, the above-mentioned, most likely, to deserve, should, ought to, owe
问题	wèntí	problem, issue, topic
开学	kāixué	school opens, new term begins
很	hěn	very, extremely
高	gāo	high, tall
看	kàn	to look after, to take care of, to watch, to guard / it depends, think, to see, to look at
教授	jiàoshòu	university professor
介绍	jièshào	to present, introduction, to introduce
中文	zhōngwén	Chinese language
学	xué	learn, study, science, -ology
专业	zhuānyè	specialized field
美术	měishù	the fine arts, art
美	měi	America, beautiful
文学	wénxué	literature
系	xì	be, system, to tie, department, faculty
忙	máng	busy
妈妈	māma	mama, mommy
他们	tāmen	they
哥哥	gēge	older brother
咖啡	kāfēi	coffee
我们	wǒmen	we, us, ourselves
喝	hē	to drink
今年	jīnnián	this year
年	nián	year
怎么样	zěnme yàng 	how is it
今天	jīntiān	today, at the present, now
星期	xīngqī	week
上午	shàngwǔ	morning
下午	xiàwǔ	afternoon
星期日	xīngqīrì	Sunday
生日	shēngrì	birthday
生	shēng	to be born, to give birth, life, to grow
多大	duōdà	how big, how much, how old, etc.
出生	chūshēng	to be born
属	shǔ	category, class, family, to belong to / enjoin
祝贺	zhùhè	to congratulate, congratulations
祝	zhù	invoke, pray to, wish, to express good wishes
参加	cānjiā	to participate, to take part, to join
吃	chī	eat, eradicate, destroy, receive / stammer
蛋糕	dàngāo	cake
蛋	dàn	egg, oval shaped
买	mǎi	buy
红葡萄酒	hóngpútaojiǔ	red wine
红	hóng	red
酒	jiǔ	wine, liquor, spirits
快乐	kuàilè	happy, merry
漂亮	piàoliang	pretty, beautiful
烤鸭	kǎoyā	roast duck
鸭	yā	duck
面	miàn	fade, side, surface, aspect, top, face, flour, noodles
去	qù	to go, to leave, to remove
游泳	yóuyǒng	swim
京剧	jīngjù	Beijing opera
有意思	yǒu yìsi	interesting
天	tiān	day, sky, heaven
天气	tiānqì	weather
时候	shíhou	time, length of time, moment, period
现在	xiànzài	modern, current, present, at present, now, nowadays
明天	míngtiān	tomorrow
有	yǒu	to have, there is, there are, to exist, to be
时间	shíjiān	time, period
遍	biàn	a time, everywhere, turn, all over, one time
打球	dǎqiú	to play ball
打	dǎ	beat, strike, break, mix up, build, fight, fetch, make, tie up, issue, shoot, calculate, since, from
球	qiú	ball, sphere
抱歉	bàoqiàn	be sorry, feel apologetic, regret
行	xíng	all right, capable, competent, OK, okay
也	yě	also; too
