舅妈	舅媽	jiu4 ma1	/aunt (wife of mother's brother)/
舅舅	舅舅	jiu4 jiu5	/(n) maternal uncle / (informal) mothers brother; maternal uncle/
农民	農民	nong2 min2	/peasant/
当	當	dang1	/to be, to act as, manage, withstand, when, during, ought, should, match equally, equal, same, obstruct, just at (a time or place), on the spot, right, just at / at or in the very same..., to pawn, suitable, adequate, fitting, proper, replace, represent/
蔬菜	蔬菜	shu1 cai4	/vegetables, produce/
菜	菜	cai4	/dish (type of food), vegetables/
正在	正在	zheng4 zai4	/in the process of (doing something or happening), while (doing)/
在	在	zai4	/(located) at, in, exist/
问路	問路	wen4 lu4	/ask for directions/
变化	變化	bian4 hua4	/change, vary/
不但	不但	bu2 dan4	/not only (... but also...)/
而且	而且	er2 qie3	/not only ... but also ...., ... as well as ..., moreover, in addition/
可不	可不	ke3 bu5	/that's just the way it is, exactly/
小孩	小孩	xiao3 hai2	/child/
地图	地圖	di4 tu2	/map/
向	向	xiang4	/direction, part, side, towards, to, guide, opposite to/
像	像	xiang4	/(look) like; similar (to); to look; to appear; to seem; image; portrait/
上	上	shang4	/on, on top, upon, first (of two parts), previous or last (week, etc.), upper, higher, above, previous, to climb, to go into, above, to go up/
年级	年級	nian2 ji2	/grade/
大学	大學	da4 xue2	/university/
辛苦	辛苦	xin1 ku3	/hard, exhausting, with much toil/
下雨	下雨	xia4 yu3	/rainy/
雨	雨	yu3	/rain/
种	種	zhong3	/kind, type, race (of people), seed, type/
温室	溫室	wen1 shi4	/greenhouse/
温	溫	wen1	/(luke)warm, to review/
收入	收入	shou1 ru4	/to take in, income, revenue/
收	收	shou1	/to receive, to accept, to collect/
入	入	ru4	/to enter/
前年	前年	qian2 nian2	/the year before last/
盖	蓋	gai4	/to build/
座	座	zuo4	/measure word for buildings, mountains and similar immovable objects/
辆	輛	liang4	/(a measure word for vehicles)/
城市	城市	cheng2 shi4	/city, town/
城	城	cheng2	/city walls, city, town/
方便	方便	fang1 bian4	/convenient/
村	村	cun1	/village/
文化	文化	wen2 hua4	/culture, civilization, cultural/
低	低	di1	/to lower (ones head), to let droop, to hang down, low, to incline, beneath, low/
技术	技術	ji4 shu4	/technology, technique, skill/
管理	管理	guan2 li3	/to supervise, to manage, to administer, management, administration/
