今年	今年	jin1 nian2	/this year/
年	年	nian2	/year/
岁	歲	sui4	/year, years old, (a measure word)/
怎么样	怎麼樣	zen3 me5 yang4	/how is it/
今天	今天	jin1 tian1	/today, at the present, now/
课	課	ke4	/subject, class, lesson / class, lesson/
星期	星期	xing1 qi1	/week/
上午	上午	shang4 wu3	/morning/
上	上	shang4	/on, on top, upon, first (of two parts), previous or last (week, etc.), upper, higher, above, previous, to climb, to go into, above, to go up/
下午	下午	xia4 wu3	/afternoon/
下	下	xia4	/under, second (of two parts), next (week, etc.), lower, below, underneath, down(wards), to decline, to go down, latter/
星期日	星期日	xing1 qi1 ri4	/Sunday/
号	號	hao4	/roar, cry / day of a month, (suffix used after) name of a ship, (ordinal) number/
生日	生日	sheng1 ri4	/birthday/
生	生	sheng1	/to be born, to give birth, life, to grow/
多大	多大	duo1 da4	/how big, how much, how old, etc./
多	多	duo1	/many, much, a lot of, numerous, multi-/
大	大	da4	/big, huge, large, major, great, wide, deep, oldest, eldest / doctor/
出生	出生	chu1 sheng1	/to be born/
出	出	chu1	/to go out, to come out, to occur, to produce, to go beyond, to rise, to put forth, to occur, to happen, (a measure word for dramas, plays, or operas)/
属	屬	shu3	/category, class, family, to belong to / enjoin/
聚会	聚會	ju4 hui4	/(v) meet; gather, (n) meeting; gathering/
会	會	hui4	/can, be possible, be able to, to assemble, to meet, to gather, to see, union, group, association / to balance an account, accounting/
祝贺	祝賀	zhu4 he4	/to congratulate, congratulations/
祝	祝	zhu4	/invoke, pray to, wish, to express good wishes/
参加	參加	can1 jia1	/to participate, to take part, to join/
了	了	le5	/(modal particle intensifying preceding clause), (past tense marker) / to know, to understand, to know/
吃	吃	chi1	/eat, eradicate, destroy, receive / stammer/
蛋糕	蛋糕	dan4 gao1	/cake/
蛋	蛋	dan4	/egg, oval shaped/
糕	糕	gao1	/cake/
买	買	mai3	/buy/
瓶	瓶	ping2	/bottle, (a measure word), vase, pitcher/
红葡萄酒	紅葡萄酒	hong2 pu2 tao5 jiu3	/red wine/
红	紅	hong2	/red/
葡萄	葡萄	pu2 tao5	/grape/
酒	酒	jiu3	/wine, liquor, spirits/
宋华	宋華	song4 hua2	/Song Hua (a personal name)/
北京	北京	bei3 jing1	/Beijing (capital of mainland China)/
快乐	快樂	kuai4 le4	/happy, merry/
漂亮	漂亮	piao4 liang5	/pretty, beautiful/
烤鸭	烤鴨	kao3 ya1	/roast duck/
鸭	鴨	ya1	/duck/
喝	喝	he1	/to drink/
再	再	zai4	/again, once more, re-, second, another/
寿面	壽麵	shou4 mian4	/birthday noodles (for longevity)/
面	面	mian4	/fade, side, surface, aspect, top, face, flour, noodles/
