着	著	zhe5	/particle attached after verb to indicate action in progress, like -ing ending/
送	送	song4	/to deliver, to carry, to give (as a present), to present (with), to see off, to send/
被	被	bei4	/by (marker for passive-voice sentences or clauses), quilt, blanket, to cover, to wear/
撞	撞	zhuang4	/to hit, to strike, to meet by accident, to run into, to bump against, to bump into/
伤	傷	shang1	/injure, injury, wound/
第	第	di4	/(prefix before a number, for ordering numbers, e.g. first, number two, etc)/
检查	檢查	jian3 cha2	/inspection, examine/
重	重	zhong4	/to double, to repeat, repetition, iteration, again, a layer / heavy, serious/
完	完	wan2	/to finish, to be over, whole, complete, entire/
马上	馬上	ma3 shang4	/at once, right away, immediately/
胳膊	胳膊	ge1 bo5	/(n) arm/
腿	腿	tui3	/leg/
骑	騎	qi2	/to ride (an animal or bike), to sit astride/
自行车	自行車	zi4 xing2 che1	/bicycle/
笑	笑	xiao4	/laugh, smile/
注意	注意	zhu4 yi4	/take note of, (pay) attention (to)/
停	停	ting2	/to stop, to halt/
医药费	醫藥費	yi1 yao4 fei4	/medical expenses/
以为	以爲	yi3 wei2	/to believe; to think; to consider; to be under the impression/
如果	如果	ru2 guo3	/if, in case, in the event that/
躺	躺	tang3	/to recline, to lie down/
电视	電視	dian4 shi4	/television, TV/
视	視	shi4	/to look at, to regard, to inspect/
束	束	shu4	/bunch, (a measure word), to bind, to control/
放	放	fang4	/to release, to free, to let go, to put, to place, to let out/
桌子	桌子	zhuo1 zi5	/table, desk/
结果	結果	jie2 guo3	/outcome, result/
关	關	guan1	/(surname), mountain pass, to close, to shut, to turn off, to concern, to involve/
弯	彎	wan1	/bend, bent/
倒霉	倒黴	dao3 mei2	/bad luck/
坏	壞	huai4	/bad/
消息	消息	xiao1 xi5	/news, information/
小偷	小偷	xiao3 tou1	/(n) thief/
偷	偷	tou1	/to steal, to pilfer/
派出所	派出所	pai4 chu1 suo3	/(n) local police station/
抓	抓	zhua1	/to grab, to catch, to arrest, to snatch/
丢	丟	diu1	/to lose, to put aside, to throw/
