姑娘	姑娘	gu1 niang5	/girl/
听说	聽說	ting1 shuo1	/to hear something being said/
听	聽	ting1	/listen, hear, obey / let, allow/
得	得	de2	/obtain, get, gain, proper, suitable, proud, contented, allow, permit, ready, finished / a sentence particle used after a verb to show effect, degree or possibility / to have to, must, ought to, to need to/
告诉	告訴	gao4 su5	/to tell, to inform, to let know/
件	件	jian4	/(a measure word for thing, clothes, item/
事儿	事兒	shi4 r5	/business, thing/
散步	散步	san4 bu4	/to take a walk, to go for a walk/
步	步	bu4	/a step, a pace, walk, march, stages in a process/
电影	電影	dian4 ying3	/movie, film/
电	電	dian4	/electric, electricity, electrical/
影	影	ying3	/picture, image, reflection, shadow/
咖啡	咖啡	ka1 fei1	/coffee/
可是	可是	ke3 shi4	/but, however/
宿舍	宿舍	su4 she4	/dormitory, living quarters/
找	找	zhao3	/to try to find, to look for, to call on (sb), to find, to seek, to return, to look for/
房子	房子	fang2 zi5	/house/
租	租	zu1	/rent; taxes/
间	間	jian1	/between, among, space, (measure word) / interstice, separate/
厨房	廚房	chu2 fang2	/kitchen/
厕所	廁所	ce4 suo3	/toilet; lavatory/
房租	房租	fang2 zu1	/rent for a room or house/
公司	公司	gong1 si1	/(business) company, company, firm, corporation, incorporated/
办	辦	ban4	/to do, to manage, to handle, to go about, to run, to set up, to deal with/
打电话	打電話	da3 dian4 hua4	/to make a telephone call/
电话	電話	dian4 hua4	/telephone, phone call/
让	讓	rang4	/to ask, to let, permit, have (someone do something), to yield, to allow/
帮助	幫助	bang1 zhu4	/assistance, aid, to help, to assist/
喂	喂	wei4	/(interjection) hello, to feed (someone or some animal), hey, telephone greeting/
位	位	wei4	/position, location, (measure word for persons), place, seat/
经理	經理	jing1 li3	/manager, director/
可能	可能	ke3 neng2	/might (happen), possible, probable, possibility, probability/
吃饭	吃飯	chi1 fan4	/to eat a meal/
饭	飯	fan4	/food, cuisine, cooked rice, meal/
等	等	deng3	/class, rank, grade, equal to, same as, wait for, await, et cetera, and so on/
家美	家美	jia1 mei3	/(name of a house rental agency)/
