全身	全身	quan2 shen1	/all over (the body)/
全	全	quan2	/all, whole, entire, every, complete/
身	身	shen1	/body, torso, person, life, status, pregnancy, (a measure word used for clothes) suit/
舒服	舒服	shu1 fu5	/comfortable/
每	每	mei3	/each, every/
锻炼	鍛煉	duan4 lian4	/to do physical training/
头	頭	tou2	/head / suff. for nouns/
疼	疼	teng2	/(it) hurts, love fondly, ache, pain, sore/
嗓子	嗓子	sang3 zi5	/throat, voice/
想	想	xiang3	/to think, to believe, to suppose, to wish, to want, to miss/
医院	醫院	yi1 yuan4	/hospital/
看病	看病	kan4 bing4	/see a doctor, see a patient/
病	病	bing4	/ailment, sickness, illness, disease, fall ill, sick, defect/
身体	身體	shen1 ti3	/(human) body, health/
要	要	yao4	/demand, ask, request, coerce / important, vital, to want, to be going to, must/
吧	吧	ba5	/(onomat.), dumb / (modal particle indicating polite suggestion), ...right?, ...OK?/
还是	還是	hai2 shi4	/or, still, nevertheless/
一起	一起	yi4 qi3	/together/
冷	冷	leng3	/cold/
穿	穿	chuan1	/to bore through, pierce, perforate, penetrate, pass through, to dress, to wear, to put on, to thread/
衣服	衣服	yi1 fu5	/clothes/
休息	休息	xiu1 xi5	/rest, to rest/
给	給	gei3	/to, for, for the benefit of, to give, to allow, to do sth (for sb), (passive particle) / to supply, provide/
挂号	掛號	gua4 hao4	/to register (a letter, at a hotel, etc.)/
号	號	hao4	/roar, cry / day of a month, (suffix used after) name of a ship, (ordinal) number/
有点儿	有點兒	you2 dian3 r5	/(adv) slightly; little; somewhat/
发炎	發炎	fa1 yan2	/become inflamed from infection or injury; inflamation/
发烧	發燒	fa1 shao1	/have a high temperature (from illness), have a fever/
烧	燒	shao1	/to burn, to cook, to stew, to bake, to roast, fever/
感冒	感冒	gan3 mao4	/to catch cold, (common) cold/
住院	住院	zhu4 yuan4	/to be in hospital, to be hospitalized/
水	水	shui3	/water, river/
药	藥	yao4	/medicine, drug, cure/
愿意	願意	yuan4 yi4	/to wish, to want, ready, willing (to do sth)/
中药	中藥	zhong1 yao4	/(traditional) Chinese medicine/
西药	西藥	xi1 yao4	/Western medicine/
西	西	xi1	/west/
