会	會	hui4	/can, be possible, be able to, to assemble, to meet, to gather, to see, union, group, association / to balance an account, accounting/
(一)点儿	(一)點兒	yi4 dian3 r5	/a bit; a little/
司机	司機	si1 ji1	/chauffeur, driver/
点(钟)	點(鐘)	dian3 zhong1	/(indicating time of day) o'clock/
差	差	cha4	/difference, error, discrepancy, to differ, to err, to make a mistake, to lack / different, short of, poor, to lack / send, a messenger, a mission, to commission / uneven/
刻	刻	ke4	/quarter (hour), (a measure word), to carve, to engrave, to cut, oppressive/
回	回	hui2	/(a measure word for matters or actions) a time, to circle, to go back, to turn around, to answer, to return, to revolve/
上课	上課	shang4 ke4	/to attend class/
上	上	shang4	/on, on top, upon, first (of two parts), previous or last (week, etc.), upper, higher, above, previous, to climb, to go into, above, to go up/
能	能	neng2	/can, may, capable, energy, able/
到	到	dao4	/to (a place), until (a time), up to, to go, to arrive/
哪里	哪里	na3 li5	/where/
教	教	jiao1	/teach / religion, teaching/
英语	英語	ying1 yu3	/English (language)/
孙女儿	孫女兒	sun1 nv5 r5	/granddaughter (daughter of one's son)/
女儿	女兒	nv3 er2	/daughter/
岁数	歲數	sui4 shu5	/age (number of years old)/
数	數	shu4	/number; figure; several/
还	還	hai2	/also, in addition, more, still, else, still, yet, (not) yet / (surname), pay back, return/
分	分	fen1	/to divide, minute, (a measure word), (a unit of length = 0.33 centimeter) / part/
拜拜	拜拜	bai2 bai2	/bye bye/
为什么	爲什麼	wei4 shen2 me5	/why; for what reason/
为	爲	wei4	/for/
昨天	昨天	zuo2 tian1	/yesterday/
东西	東西	dong1 xi5	/thing, person/
玩儿	玩兒	wan2 r5	/to play/
晚上	晚上	wan3 shang5	/in the evening/
晚	晚	wan3	/evening, night, late/
半	半	ban4	/half, semi-, incomplete, (after a number) and a half, half/
写	寫	xie3	/to write/
汉字	漢字	han4 zi4	/Chinese character/
字	字	zi4	/letter, symbol, character, word/
睡觉	睡覺	shui4 jiao4	/to go to bed, to go to sleep/
睡	睡	shui4	/to sleep/
起床	起床	qi3 chuang2	/to get up/
起	起	qi3	/to rise, to raise, to get up/
床	床	chuang2	/bed, couch, (a measure word)/
应该	應該	ying1 gai1	/ought to, should, must/
该	該	gai1	/that, the above-mentioned, most likely, to deserve, should, ought to, owe/
问题	問題	wen4 ti2	/problem, issue, topic/
可以	可以	ke2 yi3	/can, may, possible, able to/
陈	陳	chen2	/arrange, exhibit, narrate, tell, old, stale, a surname, to state, to display, to explain, (surname)/
