把	把	ba3	/(a measure word), (marker for direct-object), to hold, to contain, to grasp, to take hold of / handle/
忘	忘	wang4	/to forget, to overlook, to neglect/
图书馆	圖書館	tu2 shu1 guan3	/library/
图书	圖書	tu2 shu1	/books (in a library or bookstore)/
馆	館	guan3	/house, establishment/
办公室	辦公室	ban4 gong1 shi4	/office/
办公	辦公	ban4 gong1	/handle official business, work (usually in an office)/
室	室	shi4	/room/
上	上	shang4	/on, on top, upon, first (of two parts), previous or last (week, etc.), upper, higher, above, previous, to climb, to go into, above, to go up/
先	先	xian1	/early, prior, former, in advance, first/
借书证	借書證	jie4 shu1 zheng4	/library card/
借	借	jie4	/to lend, to borrow, excuse, pretext, by means of/
证	證	zheng4	/to prove, to demonstrate, to confirm, certificate, proof/
一会儿	一會兒	yi2 hui4 r5	/a while/
下	下	xia4	/under, second (of two parts), next (week, etc.), lower, below, underneath, down(wards), to decline, to go down, latter/
带	帶	dai4	/band, belt, girdle, ribbon, area, zone, region, wear, carry, lead, bring, consists of, show, and/
填	填	tian2	/to fill in/
表	表	biao3	/surface, exterior, to watch, to show, express, an example, a list or table, a meter, a watch, chart, external/
拿	拿	na2	/to hold, to seize, to catch, to apprehend, to take/
慢	慢	man4	/slow/
不行	不行	bu4 xing2	/wont do, be out of the question, be no good, not work, not be capable/
生活	生活	sheng1 huo2	/life, activity/
自己	自己	zi4 ji3	/self, (reflexive pronoun), own/
姓名	姓名	xing4 ming2	/name and surname/
性别	性別	xing4 bie2	/distinguishing between the sexes/
职业	職業	zhi2 ye4	/job occupation, profession/
交	交	jiao1	/to deliver, to turn over, to make friends, to intersect (lines), to pay (money)/
长	長	chang2	/length, long/
考试	考試	kao3 shi4	/exam/
考	考	kao3	/to check, to verify, to test, to examine/
不错	不錯	bu2 cuo4	/correct, right, not bad, pretty good/
翻译	翻譯	fan1 yi4	/translate/
新	新	xin1	/meso- (chem.), new, newly/
课本	課本	ke4 ben3	/textbook/
出	出	chu1	/to go out, to come out, to occur, to produce, to go beyond, to rise, to put forth, to occur, to happen, (a measure word for dramas, plays, or operas)/
还	還	huan2	/pay back, return/
过期	過期	guo4 qi1	/to be overdue/
过	過	guo4	/(past tense marker), to cross, to go over, to pass (time), to live, to get along, (surname)/
期	期	qi1	/a period of time, phase, stage, (used for issue of a periodical, courses of study), time, term, period, to hope/
罚款	罰款	fa2 kuan3	/(impose a) fine, penalty, fine (monetary)/
罚	罰	fa2	/to punish, to penalize/
款	款	kuan3	/section, paragraph, funds/
电脑	電腦	dian4 nao3	/computer/
电	電	dian4	/electric, electricity, electrical/
脑	腦	nao3	/brain/
查	查	cha2	/to research, to check, to investigate, to examine, to refer to, to search / (surname)/
新实用汉语课本	新實用漢語課本	xin1 shi2 yong4 han4 yu3 ke4 ben3	/New Practical Chinese Reader/
实用	實用	shi2 yong4	/practical, functional, pragmatic/
